10 10
5 9
80 80 80 80 80 80 80 80 80 80
80 90 90 90 90 90 90 90 90 80
80 90 90 90 90 90 90 90 90 80
80 90 90 90 90 90 90 90 90 80
80 90 90 90 90 90 90 90 90 80
80 90 90 90 90 90 90 90 90 80
80 90 90 90 90 90 90 90 90 80
80 90 90 90 90 90 90 90 90 80
80 90 90 90 90 90 90 90 90 80
80 80 80 80 80 90 80 80 80 80