12 30
400 400
52 52 54 54 54 54 54 54 54 54 52 52
52 52 53 53 53 53 53 53 53 53 52 52
52 52 52 52 52 52 52 52 52 52 52 52
 1  1  1  1  1  1  1  1  1  1 51 51
 1  1  1  1  1  1  1  1  1  1  1  1
 1  1  1 11 11 11 11 11 11  1  1  1
 1  1 14  2  2  2  2  2  2 13  1  1
 1  1  1 12 18  2 17 12 12  1  1  1
 1  1  1  1 14  2 13  1  1  1  1  1
 1  1  1  1 14  2 13  1  1  1  1  1
 1  1  1  1 14  2 13  1  1  1  1  1
 1  1  1  1  1  1  1  1  1  1  1  1
 1  1  1  1  1  1  1  1  1  1  1  1
 1  1  1  1 66  1 46  1  1  1  1  1
 1  1  1  1 52 19 52  1  1  1  1  1
54 54 54 54 52 19 52 54 54 54 54 54
 1  1  1  1 19 19 19  1  1  1  1  1
 1  1  1  1  1  1  1  1  1  1  1  1
 1  1  1  1  1  1  1  1  1  1  1  1
 1  1  1  1  1  1  1  1  1  1  1  1
 1  1  1  1  1  1  1  1  1  1  1  1
 1  1  1  1  1  1  1  1  1  1  1  1
 1  1  1  1  1  1  1  1  1  1  1  1
 1  1  1  1  1  1  1  1  1  1  1  1
 1  1  1  1 66  1 46  1  1  1  1  1
 1  1  1  1 52 19 52  1  1  1  1  1
54 54 54 54 52 19 52 54 54 54 54 54
 1  1  1  1 19 19 19  1  1  1  1  1
 1  1  1  1  1  1  1  1  1  1  1  1
 1  1  1  1  1  1  1  1  1  1  1  1