56 66  0  0  0  0  0  0  0  0 46 56
55 65  0  0  0  0  0  0  0  0 45 55
54 64  0  0  0  0  0  0  0  0 45 55
51 51 51 51 51 51 51 51 51 51  0  0
 0  0 50 50 50 50 50 50 50 50  0  0
 0  0  0  0 31  0  0  0  0  0  0  0
52 62  0  0  0  0  0  0  0  0  0  0
51 61  0  0  0  0  0 31  0  0 42 52
71 60  0  0  0  0  0  0  0  0 41 51
71  0  0  0  0  0  0  0  0  0 40 71
71  0  0  0 31  0  0  0  0  0  0 71
71  0  0  0  0  0  0  0  0  0  0 71
71  0  0  0  0  0  0  0  0  0  0 71
71  0  0  0  0  0  0  0  0  0  0 71
74 70 70 70 73  0 72 70 70 70 70 75