56 66  0  0  0  0  0  0  0  0 46  0
55 65  0  0  0  0  0  0  0  0 45  0
54 64  0  0  0  0  0  0  0  0 45  0
51 51 51 51 51 51 51 51 51 51  0  0
 0  0 50 50 50 50 50 50 50 50  0  0
 0  0  0  0 31  0  0  0  0  0  0  0
52 62  0  0  0  0  0  0  0  0  0  0
51 61  0  0  0  0  0 31  0  0 42  0
50 60  0  0  0  0  0  0  0  0 41  0
 0  0  0  0  0  0  0  0  0  0 40  0
 0  0  0  0 31  0  0  0  0  0  0  0
 0  0  0  0  0  0  0  0  0  0  0  0
 0  0  0  0  0  0  0  0  0  0  0  0
 0  0  0  0  0  0  0  0  0  0  0  0
 0  0  0  0  0  0  0  0  0  0  0  0