56 66  0  0  0  0  0  0  0  0 46 56
55 65  0  0  0  0  0  0  0  0 45 55
54 64  0  0  0  0  0  0  0  0 45 55
51 51 51 51 51 51 51 51 51 51  0  0
 0  0 50 50 50 50 50 50 50 50  0  0
 0  0  0  0 31  0  0  0  0  0  0  0
52 62  0  0  0  0  0  0  0  0  0  0
51 61  0  0  0  0  0 31  0  0 42 52
60 60  0  0  0  0  0  0  0  0 41 51
71  0  0  0  0  0  0  0  0  0 40 40
71  0  0  0 31  0  0  0  0  0  0 71
71  0  0  0  0  0  0  0  0  0  0 71
71  0  0  0  0  0  0  0  0  0  0 71
71  0  0  0  0  0  0  0  0  0  0 71
71  0  0  0 65  0 45  0  0  0  0 71
 0  0  0  0 64  0 44  0  0  0  0  0
51 51 51 51 61  0 41 51 51 51 51 51
50 50 50 50 60  0 40 50 50 50 50 50
88 83  0  0  0  0  0  0  0  0  0  0
88 83  0  0  0  0  0  0  0  0  0  0
88 83  0  0  0  0  0  0  0  0  0  0
88 83  0  0  0  0  0  0  0  0  0  0
88 83  0  0  0  0  0  0  0  0  0  0
88 83  0  0  0  0  0  0  0  0  0  0
88 83  0  0  0  0  0  0  0  0  0  0
88 89  0 90 65  0 45 89  0  0  0  0
80 80 80 80 64  0 44 80 80 80 80 80
51 51 51 51 61  0 41 51 51 51 51 51
50 50 50 50 60  0 40 50 50 50 50 50
 0  0  0  0  0  0  0  0  0  0  0  0