12 15
400 400
52 52 54 54 54 54 54 54 54 54 52 52
52 52 53 53 53 53 53 53 53 53 52 52
52 52 52 52 52 52 52 52 52 52 52 52
 1  1  1  1  1  1  1  1  1  1 51 51
 1  1  1  1  1  1  1  1  1  1  1  1
 1  1  1 11 11 11 11 11 11  1  1  1
 1  1 14  2  2  2  2  2  2 13  1  1
 1  1  1 12 12 12 12 12 12  1  1  1
 1  1  1  1  1  1  1  1  1  1  1  1
 1  1  1  1  1  1  1  1  1  1  1  1
 1  1  1  1  1  1  1  1  1  1  1  1
 1  1  1  1  1  1  1  1  1  1  1  1
 1  1  1  1  1  1  1  1  1  1  1  1
 1  1  1  1  1  1  1  1  1  1  1  1
 1  1  1  1  1  1  1  1  1  1  1  1