0   0  0  0  0  0  0  0  0  0  0  0
 0  0  0  0  0  0  0  0  0  0  0  0
 0  0  0  0  0  0  0  0  0  0  0  0
53 63  0  0  0  0  0  0  0  0 44 54
52 62  0  0  0  0  0  0  0  0 43 53
53 63  0  0  0  0  0  0  0  0 42 52
 0  0  0  0  0  0  0  0  0  0 43 53
 0  0  0  0  0  0  0  0  0  0  0  0
 0  0  0  0  0  0  0  0  0  0  0  0
 0  0  0  0  0  0  0  0  0  0  0  0
 0  0  0  0  0  0  0  0  0  0  0  0
 0  0  0  0  0  0  0  0  0  0  0  0
 0  0  0  0  0  0  0  0  0  0  0  0
 0  0  0  0  0  0  0  0  0  0  0  0
 0  0  0  0  0  0  0  0  0  0  0  0
74 73  0  0  0  0  0  0  0  0 72 75
81 87  0  0  0  0  0  0  0  0  0  0
88 83  0  0  0  0  0  0  0  0  0  0
 0  0  0  0  0  0  0  0  0  0  0  0
 0  0  0  0  0  0  0  0  0  0  0  0
 0  0  0  0  0  0  0  0  0  0  0  0
 0  0  0  0  0  0  0  0  0  0  0  0
 0  0  0  0  0  0  0  0  0  0  0  0
 0  0  0  0  0  0  0  0  0  0  0  0
 0  0  0 86 87  0 86 87  0  0  0  0
 0  0 81  0 83  0 82  0 81 81 81 81
 0  0  0  0 85  0 84  0  0  0  0  0
 0  0  0  0  0  0  0  0  0  0  0  0
 0  0  0  0 74 70 75  0  0  0  0  0
 0  0  0  0  0  0  0  0  0  0  0  0