0   0  0  0  0  0  0  0  0  0  0  0  0  0  0  0  0  0  0  0  0  0  0  0  0  0  0  0  0  0
 0  0  0  0  0  0  0  0  0  0  0  0  0  0  0  0  0  0  0  0  0  0  0  0  0  0  0  0  0  0
 0  0  0  0  0  0  0  0  0  0  0  0  0  0  0  0  0  0  0  0  0  0  0  0  0  0  0  0  0  0
53 63  0  0  0  0  0  0  0  0 44 54 54 54 54 54 54 54 54 54 54 54 54 54 54 54 54 54 54 54
52 62  0  0  0  0  0  0  0  0 43 53 53 53 53 53 53 53 53 53 53 53 53 53 53 53 53 53 53 53
53 63  0  0  0  0  0  0  0  0 42 52 52 52 52 52 52 52 52 52 52 52 52 52 52 52 52 52 52 52
 0  0  0  0  0  0  0  0  0  0 43 53 53 53 53 53 53 53 53 53 53 53 53 53 53 53 53 53 53 53
 0  0  0  0  0  0  0  0  0  0  0  0  0  0  0  0  0  0  0  0  0  0  0  0  0  0  0  0  0  0
71  0  0  0  0  0  0  0  0  0  0  0  0  0  0  0  0  0  0  0  0  0  0  0  0  0  0  0  0  0
 0  0  0  0  0  0  0  0  0  0  0 71  0  0  0  0  0  0  0  0  0  0  0  0  0  0  0  0  0  0
 0  0  0  0  0  0  0  0  0  0  0  0  0  0  0  0  0  0  0  0  0  0  0  0  0  0  0  0  0  0
 0  0  0  0  0  0  0  0  0  0  0  0  0  0  0  0  0  0  0  0  0  0  0  0  0  0  0  0  0  0
 0  0  0  0  0  0  0  0  0  0  0  0  0  0  0  0  0  0  0  0  0  0  0  0  0 81 81 81 81 81
 0  0  0  0  0  0  0  0  0  0  0  0  0  0  0  0  0  0  0  0  0  0  0  0  0 88 88 88 88 88
 0  0  0  0  0  0  0  0  0  0  0  0  0  0  0  0  0  0  0  0  0  0  0  0  0 88 88 88 88 88
74 73  0  0  0  0  0  0  0  0 72 75  0  0  0  0  0  0  0  0  0  0  0  0  0 80 80 80 92 88
81 87  0  0  0  0  0  0  0  0  0  0  0  0  0  0  0  0  0  0  0  0  0  0  0  0  0  0 82 88
88 83  0  0  0  0  0  0  0  0  0  0  0  0  0  0  0  0  0  0  0  0  0  0  0  0  0  0 82 88
 0  0  0  0  0  0  0  0  0  0  0  0  0  0  0  0  0  0  0  0  0  0  0  0  0  0  0  0 82 88
 0  0  0  0  0  0  0  0  0  0  0  0  0  0  0  0  0  0  0  0  0  0  0  0  0  0  0  0 82 88
 0  0  0  0  0  0  0  0  0  0  0  0  0  0  0  0  0  0  0  0  0  0  0  0  0  0  0  0 82 88
 0  0  0  0  0  0  0  0  0  0  0  0  0  0  0  0  0  0  0  0 37 37 37  0  0  0  0  0 82 88
 0  0  0  0  0  0  0  0  0  0  0  0  0  0  0  0  0  0  0  0  0  0  0  0  0  0  0  0 82 88
 0  0  0  0  0  0  0  0  0  0  0  0  0  0  0  0  0  0  0  0  0  0  0  0  0  0  0  0 82 88
 0  0  0 86 87  0 86 87  0  0  0  0  0  0  0  0  0  0  0  0  0  0  0  0  0  0  0  0 82 88
 0  0 81  0 83  0 82  0 81 81 81 81 81 81 81 81 81 81 81 81 81 81 81 81 81 81 81 81 84 80
 0  0  0  0 85  0 84  0  0  0  0  0  0  0  0  0  0  0  0  0  0  0  0  0  0  0  0  0  0  0
 0  0  0  0  0  0  0  0  0  0  0  0  0  0  0  0  0  0  0  0  0  0  0  0  0  0  0  0  0  0
 0  0  0  0 74 70 75  0  0  0  0  0  0  0  0  0  0  0  0  0  0  0  0  0  0  0  0  0  0  0
 0  0  0  0  0  0  0  0  0  0  0  0  0  0  0  0  0  0  0  0  0  0  0  0  0  0  0  0  0  0
