524  523  523  523  523  523  523  523  523  525
520 0 0 0 0 0 0 0 0  521
520 0 0 0 0 0 0 0 0  521
520 0 0 0 0 0 0 0 0  521
520 0 0 0 0 0 0 0 0  521
520 0 0 0 0 0 0 0 0  521
520 0 0 0 0 0 0 0 0  521
520 0 0 0 0 0 0 0 0  521
520 0 0 0 0 0 0 0 0  521
526  522  522  522  528 0  529  522  522  527