10 10
5 9
99 99  99  99  99  99  99  99  99  99 
99 100 100 100 100 100 100 100 100  99
99 100 100 100 100 100 100 100 100  99
99 110 110 110 110 110 110 110 110  99
99 110 110 110 110 110 110 110 110  99
99 110 110 110 110 110 110 110 110  99
99 110 110 110 110 110 110 110 110  99
99 110 110 110 110 110 110 110 110  99
99 110 110 110 110 110 110 110 110  99
99  99  99  99  99 110  99  99  99  99