10 10
5 9
 2  2   2   2   2   2   2   2   2    2 
 2 501 501 501 501 501 501 501 501   2
 2 500 500 500 500 500 500 500 500   2
 2 510 510 510 510 510 510 510 510   2
 2 510 510 510 510 510 510 510 510   2
 2 510 510 510 510 510 510 510 510   2
 2 510 510 510 510 510 510 510 510   2
 2 510 510 510 510 510 510 510 510   2
 2 510 510 510 510 510 510 510 510   2
 2   2   2   2   2 510   2   2   2   2