10 10
5 9
100 100 100 100 100 100 100 100 100 100
100 110 110 110 110 110 110 110 110 100
100 110 110 110 110 110 110 110 110 100
100 110 110 110 110 110 110 110 110 100
100 110 110 110 110 110 110 110 110 100
100 110 110 110 110 110 110 110 110 100
100 110 110 110 110 110 110 110 110 100
100 110 110 110 110 110 110 110 110 100
100 110 110 110 110 110 110 110 110 100
100 100 100 100 100 110 100 100 100 100