124 123 123 123 123 123 123 123 123 125
120 0 0 0 0 0 0 0 0 121
120 0 0 0 0 0 0 0 0 121
120 0 0 0 0 0 0 0 0 121
120 0 0 0 0 0 0 0 0 121
120 0 0 0 0 0 0 0 0 121
120 0 0 0 0 0 0 0 0 121
120 0 0 0 0 0 0 0 0 121
120 0 0 0 0 0 0 0 0 121
126 122 122 122 128 0 129 122 122 127